1111111111
1C0E000001
10000000C1
1P00000001
1111111111