1111111111
1E00000001
1P000000C1
1111111111