1111111111
1P00000001
1000000CE1
1111111111